20 10
zzzzzzzzzzzzzzzzzzzz
z..................z
z..................z
z..zz..............z
z..zz.....zz.......z
z..zz..............z
z..zz...z....zzz...z
z.............z....z
z..................z
zzzzzzzzzzzzzzzzzzzz
