20 10
....................
....................
....................
...zz...............
...zz.....zz........
...zz...............
...zz...z....zzz....
..............z.....
zzzzzzzzzzzzzzzzzzzz
....................